
NO ./textures/red.xpm
WE ./textures/purple.xpm
EA ./textures/orange.xpm
SO ./textures/pink.xpm

F    69, 1, 69

C    28, 15, 66




11111111
10000001
10101001
10101101
10100101
10001101
10100001
1010N101
10001001
11111111