
NO ./textures/red.xpm
WE ./textures/purple.xpm
EA ./textures/orange.xpm
SO ./textures/pink.xpm

F    8, 143, 143

C    255, 255, 255



11111111111111111
111111111111111111
1S000000000000111
111111111111111101  111111111111
                1   110000000001
                    111111111111