
NO ./textures/red.xpm
WE ./textures/purple.xpm
EA ./textures/orange.xpm
SO ./textures/pink.xpm

F    69, 1, 69

C    28, 15, 66




11111111111111111
10000000000000001
10000000000000001
10000000000000001
10000000000000001
1N000000000000001
11111111111111111