
NO ./textures/red.xpm
WE ./textures/purple.xpm
EA ./textures/orange.xpm
SO ./textures/pink.xpm

F    69, 1, 69

C    28, 15, 66




111111111111111111111111
100000000000000000000001
101111111111111111111111
100000000000000000000001
101111111111111111111111
101000000000000000000001
101000000000000000000001
101111111111111111111111
100000000000000000100001
100000000000000000100001
100000001100000000100001
10000000110000000000011
100000000000000111001
10000000000000010000111
100N00000000000100011111
111111111111111111111111