NO ./textures/red.xpm
WE ./textures/purple.xpm
EA ./textures/orange.xpm
SO ./textures/pink.xpm

F    69, 1, 69

C    28, 15, 66




111111111111111111111111                 1111111
100000000000000000000001                100000001
100000000000000000000001               10000000001
100000011111111111111111              1000000000001
10000001                             100000010000001
10000001                            10000001 10000001
100000011111111111111111           10000001   10000001
100000000000000000000001          10000001     10000001
100000000000000000000001         10000001       10000001
111111111111111110000001111111111000000111111111110000001
                100000000000N00000000000000000000000000001
                1000000111111110000001111111111111110000001
                10000001     10000001               10000001
111111111111111110000001    10000001                 10000001
100000000000000000000001   10000001                   10000001
100000000000000000000001  10000001                     10000001
111111111111111111111111 11111111                       11111111